##########
#A...#..B#
#.#.##.#.#
#.#.##.#.#
#.#....#.#
#.#.##.#.#
#....#...#
##########
